****************************************************************
*              *                                *              *
*                                                              *
*                            *    *                            *
*      *  ********************************************         *
*    *    *             f           f                *         *
*         *                                          *         *
*         *       f                                  *         *
*         *   f              f                       *         *
*         *                                          *         *
*         *                                          *         *
*      *  *          0                      1        *         *
*         *                                          *         *
*         *   f              f                       *         *
**        *                                          *        **
*   *     *              f                           *    *    *
*         *   f                                      *         *
*         *                                          *         *
*         ********************************************         *
*                                                              *
*                                                              *
*                                                              *
*                    *                    *                    *
* *                           *  *                           * *
**                                                            **
*                 *         *      *         *                 *
*             *   *                          *   *             *
*              *        *              *        *              *
*     *     *                                      *     *     *
*                                                              *
*    *              *   *              *   *              *    *
*                                                              *
*                                                              *
*    *              *   *              *   *              *    *
*                                                              *
*     *     *                                      *     *     *
*              *        *              *        *              *
*             *   *                          *   *             *
*                 *         *      *         *                 *
**                                                            **
* *                           *  *                           * *
*                    *                    *                    *
*        *            *                  *            *        *
*                          *        *                          *
*      *          *                          *          *      *
*                                                              *
*             *                                  *             *
*                    *   **          **   *                    *
*   *                                                      *   *
**                                                            **
*                          *        *                          *
*                         3          2                         *
*      *                                                *      *
*                  *                        *                  *
*    *                        *  *                        *    *
*                   *    *            *    *                   *
*                                                              *
*                                                              *
*    *                                                    *    *
*      *     *    **                        **    *     *      *
*                            *    *                            *
*                                                              *
*              *                                *              *
****************************************************************
